pennCNVpath:    /my/path/to/pennCNV
HMMpath:	/my/path/to/pennCNV/lib/hhall.hmm
HMMcreate:	0
PFB:	/my/path/to/pfb/folder
CompilePFB:	1
GCmod:	my/GC_model/path
UseGCmod:	0
InputData:	1
DATA:	/my/path/to/folder/with/raw/data
OUTPUT:	/my/path/to/folder/to/store/results
FormatedPath:	/my/path/to/folder/to/store/formated/files
Chromosome:	1-22
CNVcall:	1
Cleancall:	1
format:	1
CreateRfile:	1
AssoData:	1
NbCores:	16
PhenoPath:	/my/path/to/phenotype/file.txt
Phenotype:	PhenoName